#######################################
# Syntax Coloring Map For DFRobot_LcdDisplay
#######################################

#######################################
# Datatypes (KEYWORD1)
#######################################
DFRobot_LcdDisplay	KEYWORD1
DFRobot_Lcd_IIC	KEYWORD1
DFRobot_Lcd_UART	KEYWORD1
#######################################
# Methods and Functions (KEYWORD2)
#######################################


begin	KEYWORD2

drawPixel	KEYWORD2
lvglInit	KEYWORD2
fillScreen	KEYWORD2
setBackLight	KEYWORD2
drawLine	KEYWORD2
drawRect	KEYWORD2
fillRect	KEYWORD2
drawRoundRect	KEYWORD2
fillRoundRect	KEYWORD2
drawCircle	KEYWORD2
fillCircle	KEYWORD2
drawTriangle	KEYWORD2
fillTriangle	KEYWORD2
drawIcon	KEYWORD2
  
reset	KEYWORD2
creatSlider	KEYWORD2
setSliderValue	KEYWORD2
creatBar	KEYWORD2
setBar	KEYWORD2
creatChart	KEYWORD2
setChartTickTexts	KEYWORD2 
creatGauge	KEYWORD2
setCompassScale	KEYWORD2
setGaugeScale	KEYWORD2
setGaugeRange	KEYWORD2
setGaugeValue	KEYWORD2
creatCompass	KEYWORD2
creatArc	KEYWORD2
setArcRotation	KEYWORD2
addChart	KEYWORD2
creatLineMeter	KEYWORD2
creatChartSerie	KEYWORD2
addChartPoint	KEYWORD2
setMeterValue	KEYWORD2
setMeterScale	KEYWORD2
setMeterRange	KEYWORD2
drawString	KEYWORD2
drawStringHepler	KEYWORD2
drawLcdDate	KEYWORD2
drawLcdTime	KEYWORD2
lvglDelete	KEYWORD2

#######################################
# Constants (LITERAL1)
#######################################


eIconDial	LITERAL1
eIconDisabledAccess	LITERAL1
eIconDown	LITERAL1
eIconExit	LITERAL1
eIconExitLeft	LITERAL1
eIconExportRight	LITERAL1
eIconFireescapeStairs	LITERAL1
eIconFireExtinguisher	LITERAL1
eIconFire	LITERAL1
eIconHydrant	LITERAL1
eIconLeft	LITERAL1
eIconLifeladder	LITERAL1
eIconMedicalCare	LITERAL1
eIconRight	LITERAL1
eIconUp	LITERAL1

eIconAngry	LITERAL1
eIconBlink	LITERAL1
eIconCry	LITERAL1
eIconCute	LITERAL1
eIconDepressed	LITERAL1
eIconDizzy	LITERAL1
eIconEmbarrassed	LITERAL1
eIconFunny	LITERAL1
eIconHappy	LITERAL1
eIconKind	LITERAL1
eIconLike	LITERAL1
eIconPlayful	LITERAL1
eIconResentful	LITERAL1
eIconSad	LITERAL1
eIconSerious	LITERAL1
eIconShy	LITERAL1
eIconSmile	LITERAL1
eIconSurprised	LITERAL1
eIconTear	LITERAL1
eIconTired	LITERAL1

eIconAlcohol	LITERAL1
eIconAntennaReceiver	LITERAL1
eIconAntenna	LITERAL1
eIconBattery	LITERAL1
eIconBluetooth	LITERAL1
eIconBulb	LITERAL1
eIconCarbonDioxide	LITERAL1
eIconColor	LITERAL1
eIconCompass	LITERAL1
eIconDistance	LITERAL1
eIconDust	LITERAL1
eIconHeartRate	LITERAL1
eIconLiquid	LITERAL1
eIconMicrophone	LITERAL1
eIconMountain	LITERAL1
eIconPressure	LITERAL1
eIconRaindrops	LITERAL1
eIconThermometer	LITERAL1
eIconWeigh	LITERAL1
eIconWifi	LITERAL1
eIconWind	LITERAL1
eIconLight	LITERAL1
eIconUVLight	LITERAL1

eIconBee	LITERAL1
eIconBird	LITERAL1
eIconButterfly	LITERAL1
eIconCaterpillar	LITERAL1
eIconChick	LITERAL1
eIconChicken	LITERAL1
eIconChipmunk	LITERAL1
eIconCoccinellaSeptempunctata	LITERAL1
eIconCow	LITERAL1
eIconDog	LITERAL1
eIconDolphin	LITERAL1
eIconDragon	LITERAL1
eIconElephant	LITERAL1
eIconHorse	LITERAL1
eIconMonkey	LITERAL1
eIconOwl	LITERAL1
eIconPig	LITERAL1
eIconRabbit	LITERAL1
eIconRooster	LITERAL1
eIconSheep	LITERAL1
eIconSnail	LITERAL1
eIconSnake	LITERAL1
eIconTurtle	LITERAL1
eIconUnicorn	LITERAL1
eIconWasp	LITERAL1
eIconWorm	LITERAL1

eIconBiofuel	LITERAL1
eIconCarElectric	LITERAL1
eIconDesertLandscape	LITERAL1
eIconDirections	LITERAL1
eIconEarth	LITERAL1
eIconEcoAccumulatorBattery	LITERAL1
eIconGlassRecycle	LITERAL1
eIconGlobalWarming	LITERAL1
eIconGreenPower	LITERAL1
eIconGreenEnergy	LITERAL1
eIconGreenhouse	LITERAL1
eIconIcebergMelting	LITERAL1
eIconLandscape	LITERAL1
eIconNoPlastic	LITERAL1
eIconNoSewage	LITERAL1
eIconProtectEarth	LITERAL1
eIconRainLandscape	LITERAL1
eIconRecyclingCar	LITERAL1
eIconRelaxLandscape	LITERAL1
eIconSolar	LITERAL1
eIconTap	LITERAL1
eIconTrash	LITERAL1
eIconTreeLandscape	LITERAL1
eIconWaterRecycle	LITERAL1
eIconWinterForest	LITERAL1

eIconBeachBed	LITERAL1
eIconBeachUmbrella8	LITERAL1
eIconChristmasStocking	LITERAL1
eIconCoconut	LITERAL1
eIconFan	LITERAL1
eIconFireplace	LITERAL1
eIconGlove	LITERAL1
eIconHat	LITERAL1
eIconIceCream	LITERAL1
eIconLifeBuoy	LITERAL1
eIconSanta	LITERAL1
eIconShorts	LITERAL1
eIconSlipper	LITERAL1
eIconSnowman	LITERAL1
eIconSunny	LITERAL1
eIconSweater	LITERAL1
eIconSwimming	LITERAL1
eIconSwimwear	LITERAL1
eIconThanksgiving	LITERAL1
eIconThermometerSnow	LITERAL1
eIconWatermelon	LITERAL1

eIconAirplane	LITERAL1
eIconAmbulance	LITERAL1
eIconAutomobile	LITERAL1
eIconBicycle	LITERAL1
eIconBus	LITERAL1
eIconBusStop	LITERAL1
eIconDeliveryTruck	LITERAL1
eIconFireEngine	LITERAL1
eIconHelicopter	LITERAL1
eIconHighSpeedRailway	LITERAL1
eIconHorizontalTrafficLight	LITERAL1
eIconKickScooter	LITERAL1
eIconMotorScooter	LITERAL1
eIconMotorway	LITERAL1
eIconOncomingTaxi	LITERAL1
eIconPoliceCar	LITERAL1
eIconTractor	LITERAL1
eIconVerticalTrafficLight	LITERAL1

eIconBarn	LITERAL1
eIconBarrier	LITERAL1
eIconBoots	LITERAL1
eIconCutWood	LITERAL1
eIconEggs	LITERAL1
eIconFertilizer	LITERAL1
eIconFruits	LITERAL1
eIconMilkContainer	LITERAL1
eIconPlant	LITERAL1
eIconSheafOfRice	LITERAL1
eIconSprout	LITERAL1
eIconStorageBucket	LITERAL1
eIconTool	LITERAL1
eIconTractor2	LITERAL1
eIconVegetables	LITERAL1
eIconWateringCan	LITERAL1
eIconWellWater	LITERAL1
eIconWheelbarrow	LITERAL1

eIconDesigner	LITERAL1
eIconDiver	LITERAL1
eIconDoctor	LITERAL1
eIconLabScientist	LITERAL1
eIconMagicianMale	LITERAL1
eIconNurse	LITERAL1
eIconPhotographerMale	LITERAL1
eIconPolice	LITERAL1
eIconProgrammerMale	LITERAL1
eIconSoldier	LITERAL1
eIconSuccessGoalBusinessman	LITERAL1
eIconSurgeon	LITERAL1
eIconTeacher	LITERAL1

eIconAvocado	LITERAL1
eIconBanana	LITERAL1
eIconBeerMug	LITERAL1
eIconBentoBox	LITERAL1
eIconBirthdayCake	LITERAL1
eIconBread	LITERAL1
eIconCake	LITERAL1
eIconCarrot	LITERAL1
eIconCheeseWedge	LITERAL1
eIconCherry	LITERAL1
eIconChocolateBar	LITERAL1
eIconCutOfMeat	LITERAL1
eIconEarOfCorn	LITERAL1
eIconEgg	LITERAL1
eIconFrenchFries	LITERAL1
eIconGrapes	LITERAL1
eIconGreenSalad	LITERAL1
eIconHamburger	LITERAL1
eIconHotBeverage	LITERAL1
eIconPeach	LITERAL1
eIconPineapple	LITERAL1
eIconPopcorn	LITERAL1
eIconPotato	LITERAL1
eIconRedApple	LITERAL1
eIconSalad	LITERAL1
eIconShaomai	LITERAL1
eIconSandwich	LITERAL1
eIconShortcake	LITERAL1
eIconStrawberry	LITERAL1

eIconArrowDown	LITERAL1
eIconArrowLeft	LITERAL1
eIconArrowRight	LITERAL1
eIconArrowUp	LITERAL1
eIconDiamond	LITERAL1
eIconEight	LITERAL1
eIconFive	LITERAL1
eIconFivePointedStar	LITERAL1
eIconHeart	LITERAL1
eIconNine	LITERAL1
eIconFour	LITERAL1
eIconOctagon	LITERAL1
eIconOne	LITERAL1
eIconPentagon	LITERAL1
eIconRectangle	LITERAL1
eIconSeven	LITERAL1
eIconSix	LITERAL1
eIconSquare	LITERAL1
eIconThree	LITERAL1
eIconTriangle	LITERAL1
eIconTwo	LITERAL1
eIconWindmillShape	LITERAL1
eIconZero	LITERAL1

eIconCloudy	LITERAL1
eIconMoon	LITERAL1
eIconLightning	LITERAL1
eIconMoonCloudy	LITERAL1
eIconRainUmbrella	LITERAL1
eIconRainbow1	LITERAL1
eIconRainbow2	LITERAL1
eIconRainy	LITERAL1
eIconSnow	LITERAL1
eIconSnowy	LITERAL1
eIconSunnyCloudy	LITERAL1
eIconWhirlwind	LITERAL1

eIconAccordion	LITERAL1
eIconBassDrum	LITERAL1
eIconCDDiskDVD	LITERAL1
eIconCello	LITERAL1
eIconElectricGuitar	LITERAL1
eIconFlute	LITERAL1
eIconGuitar	LITERAL1
eIconHarmonica	LITERAL1
eIconHarp	LITERAL1
eIconHeadphones	LITERAL1
eIconMelodica	LITERAL1
eIconMusic	LITERAL1
eIconMusicStereo	LITERAL1
eIconMusicTurntable	LITERAL1
eIconMuteSoundOff	LITERAL1
eIconPiano	LITERAL1
eIconSaxophone	LITERAL1
eIconSpeakerAudio	LITERAL1
eIconTrumpet	LITERAL1
eIconXylophone	LITERAL1

eIconBadminton	LITERAL1
eIconBasketball	LITERAL1
eIconBowling	LITERAL1
eIconChess	LITERAL1
eIconCycling	LITERAL1
eIconDarts	LITERAL1
eIconDiving	LITERAL1
eIconDumbbell	LITERAL1
eIconGolf	LITERAL1
eIconIceHockey	LITERAL1
eIconKarate	LITERAL1
eIconPingPong	LITERAL1
eIconRunning	LITERAL1
eIconSoccer	LITERAL1
eIconTennis	LITERAL1
eIconYoga	LITERAL1

eIconBranch	LITERAL1
eIconCactus1	LITERAL1
eIconCactus2	LITERAL1
eIconCactus3	LITERAL1
eIconDeciduousTree	LITERAL1
eIconDecorativePottedPlants	LITERAL1
eIconFlower	LITERAL1
eIconGrass	LITERAL1
eIconGrass1	LITERAL1
eIconLeaf	LITERAL1
eIconPalmTree	LITERAL1
eIconPottedPlantFlower	LITERAL1
eIconRose	LITERAL1
eIconRose1	LITERAL1
eIconSunflower	LITERAL1
eIconSunflower1	LITERAL1
eIconTulips	LITERAL1

eChinese	LITERAL1
eShiftJis	LITERAL1
eAscii	LITERAL1
eGreece	LITERAL1
eCyrillic	LITERAL1
eHebrew	LITERAL1
eThailand	LITERAL1
eAlb	LITERAL1
eKhmer	LITERAL1
eKorean	LITERAL1


BLACK_RGB565	LITERAL1
BLUE_RGB565	LITERAL1
RED_RGB565	LITERAL1
GREEN_RGB565	LITERAL1
CYAN_RGB565	LITERAL1
MAGENTA_RGB565	LITERAL1
YELLOW_RGB565	LITERAL1
WHITE_RGB565	LITERAL1
NAVY_RGB565	LITERAL1
DARKGREEN_RGB565	LITERAL1
DARKCYAN_RGB565	LITERAL1
MAROON_RGB565	LITERAL1
PURPLE_RGB565	LITERAL1
OLIVE_RGB565	LITERAL1
LIGHTGREY_RGB565	LITERAL1
DARKGREY_RGB565	LITERAL1
ORANGE_RGB565	LITERAL1
GREENYELLOW_RGB565	LITERAL1
DCYAN_RGB565	LITERAL1
